1111111111
1P01010001
10C1011101
1101010001
1000000001
1110100C01
10C0110E11
1111111111