1111111111111111111111111111111111111111
1P00000000000000000000000000001111110001
1000100100001001001001111110001111110001
1000100111111001001001000000001000010001
1000100111111001001001111110001000010001
1000100100001001001001000000001000010001
10000000000000000000000000000000000000E1
1111111111111111111111111111111111111111
1111111111111111111111111111111111111111
1000000111000000111111111111111111111111
1000000111000000111111111111111111111111
1000000111000000111111111111111111111111
1111111111111111111111111111111111111111
