111111111111
10c0c00010c1
10P001111001
100101000001
100100000001
100001010c01
100111011001
10000c0110E1
111111111111