11111111111111111111111111111111111111111111111111111111111111111111111
1P000000010000000001111111111111111111111111111111111111111111111111111
10000000111100000001111111111111111111111111111111111111111111111111111
10010100000000000000000000000000000000000000000000000000011111111111111
1001000000000000C001111111111111111111111111111111111111111111111111111
10000000000001010001111111111111111111111111111111111111111111111111111
10000000000111011011111111111111111111111111111111111111111111111111111
10000000000000011E11111111111111111111111111111111111111111111111111111
111111101111110000C0000011101111111111111111111111111111111111111111111
11111110111111111000000000011101111111111111111111111111111111111111111
11111110111110000000000111011111111111111111111111111111111111111111111
11111110111111111111111111111111111111111111111111111111111111111111111
11111110111111111111111111111111111111111111111111111111111111111111111
11111110111111111111111111111111111111111111111111111111111111111111111
11111110111111111111111111111111111111111111111111111111111111111111111
11111110000000000000001111111111111111111111111111111111111111111111111
11111110111111111111111111111111111111111111111111111111111111111111111
11111110111111111111111111111111111111111111111111111111111111111111111
11111110111111111111111111111111111111111111111111111111111111111111111
11111110111111111111111111111111111111111111111111111111111111111111111
11111110111111111111111111111111111000000000011101111111111111111111111
11111110111111111111111111111111111111111111111111111111111111111111111
11111110111111111111111111111110000000000111011111111111111111111111111
11111110111111111111111111111111111111111111111111111111111111111111111
11111110111111111111111111111111111111111111111111111111111111111111111
11111110111111111111111111111111111111111111111111111111111111111111111
11111110111111111111111111111111111111111111111111111111111111111111111
11111110111111111111111111111111111111111111111111111111111111111111111
11111110111111111111111111111111111111111111111111111111111111111111111
11111110111111111111111111111111111111111111111111111111111111111111111
11111110111111111111111111111111111111111111111111111111111111111111111
11111110111111111111111111111111111111111111111111111111111111111111111
11111110111111111111111111111111111111111111111111111111111111111111111
11111110111111111111111111111111111111111111011111111111111111111111111
11111110000000000000000000000000000000000000011111111111111111111111111
11111111111111111111111111111111111111111111011111111111111111111111111
11111111111111111111111111111111111111111111011111111111111111111111111
11111111111111111111111111111111111111111111011111111111111111111111111
11111111111111111111111111111111111111111111011111111111111111111111111
11111111111111111111111111111111111111111111011111111111111111111111111
11111111111111111111111111111111111111111111011111111111111111111111111
11111111111111111111111111111111111111111111011111111111111111111111111
11111111111111111111111111111111111111111111011111111111111111111111111
11111111111111111111111111111111111111111111011111111111111111111111111
11111111111111111111111111111111111111111111001111111111111111111111111
11111111111111111111111111111111111111111111101111111111111111111111111
11111111111111111111111111111111111111111111101111111111111111111111111
11111111111111111111111111111111111111111111101111111111111111111111111
11111111111111111111111111111111111111111111011111111111111111111111111
11111111111111111111111111111111111111111111011111111111111111111111111
11111111111111111111111111111111111111111111011111111111111111111111111
11111111111111111111111111111111111111111111011111111111111111111111111
11111111111111111111111111111111111111111111011111111111111111111111111
11111111111111111111111111111111111111111111011111111111111111111111111
11111111111111111111111111111111111111111111011111111111111111111111111
11111111111111111111111111111111111111111111011111111111111111111111111
11111111111111111111111111111111111111111111011111111111111111111111111
11111111111111111111111111111111111111111111001111111111111111111111111
11111111111111111111111111111111111111111111101111111111111111111111111
11111111111111111111111111111111111111111111101111111111111111111111111
11111111111111111111111111111111111111111111101111111111111111111111111
11111111111111111111111111111111111111111111011111111111111111111111111
11111111111111111111111111111111111111111111011111111111111111111111111
11111111111111111111111111111111111111111111011111111111111111111111111
11111111111111111111111111111111111111111111011111111111111111111111111
11111111111111111111111111111111111111111111011111111111111111111111111
11111111111111111111111111111111111111111111011111111111111111111111111
11111111111111111111111111111111111111111111011111111111111111111111111
11111111111111111111111111111111111111111111011111111111111111111111111
11111111111111111111111111111111111111111111011111111111111111111111111
11111111111111111111111111111111111111111111001111111111111111111111111
11111111111111111111111111111111111111111111101111111111111111111111111
11111111111111111111111111111111111111111111101111111111111111111111111
11111111111111111111111111111111111111111111101111111111111111111111111
11111111111111111111111111111111111111111111011111111111111111111111111
11111111111111111111111111111111111111111111011111111111111111111111111
11111111111111111111111111111111111111111111011111111111111111111111111
11111111111111111111111111111111111111111111011111111111111111111111111
11111111111111111111111111111111111111111111011111111111111111111111111
11111111111111111111111111111111111111111111011111111111111111111111111
11111111111111111111111111111111111111111111011111111111111111111111111
11111111111111111111111111111111111111111111011111111111111111111111111
11111111111111111111111111111111111111111111011111111111111111111111111
11111111111111111111111111111111111111111111001111111111111111111111111
11111111111111111111111111111111111111111111101111111111111111111111111
11111111111111111111111111111111111111111111101111111111111111111111111
11111111111111111111111111111111111111111111101111111111111111111111111
11111111111111111111111111111111111111111111011111111111111111111111111
11111111111111111111111111111111111111111111011111111111111111111111111
11111111111111111111111111111111111111111111011111111111111111111111111
11111111111111111111111111111111111111111111011111111111111111111111111
11111111111111111111111111111111111111111111011111111111111111111111111
11111111111111111111111111111111111111111111011111111111111111111111111
11111111111111111111111111111111111111111111011111111111111111111111111
11111111111111111111111111111111111111111111011111111111111111111111111
11111111111111111111111111111111111111111111011111111111111111111111111
11111111111111111111111111111111111111111111001111111111111111111111111
11111111111111111111111111111111111111111111101111111111111111111111111
11111111111111111111111111111111111111111111101111111111111111111111111
11111111111111111111111111111111111111111111101111111111111111111111111
11111111111111111111111111111111111111111111011111111111111111111111111
11111111111111111111111111111111111111111111011111111111111111111111111
11111111111111111111111111111111111111111111011111111111111111111111111
11111111111111111111111111111111111111111111011111111111111111111111111
11111111111111111111111111111111111111111111011111111111111111111111111
11111111111111111111111111111111111111111111011111111111111111111111111
11111111111111111111111111111111111111111111011111111111111111111111111
11111111111111111111111111111111111111111111011111111111111111111111111
11111111111111111111111111111111111111111111011111111111111111111111111
11111111111111111111111111111111111111111111001111111111111111111111111
11111111111111111111111111111111111111111111101111111111111111111111111
11111111111111111111111111111111111111111111101111111111111111111111111
11111111111111111111111111111111111111111111101111111111111111111111111
11111111111111111111111111111111111111111111011111111111111111111111111
11111111111111111111111111111111111111111111011111111111111111111111111
11111111111111111111111111111111111111111111011111111111111111111111111
11111111111111111111111111111111111111111111011111111111111111111111111
11111111111111111111111111111111111111111111011111111111111111111111111
11111111111111111111111111111111111111111111011111111111111111111111111
11111111111111111111111111111111111111111111011111111111111111111111111
11111111111111111111111111111111111111111111011111111111111111111111111
11111111111111111111111111111111111111111111011111111111111111111111111
11111111111111111111111111111111111111111111001111111111111111111111111
11111111111111111111111111111111111111111111101111111111111111111111111
11111111111111111111111111111111111111111111101111111111111111111111111
11111111111111111111111111111111111111111111101111111111111111111111111
11111111111111111111111111111111111111111111011111111111111111111111111
11111111111111111111111111111111111111111111011111111111111111111111111
11111111111111111111111111111111111111111111011111111111111111111111111
11111111111111111111111111111111111111111111011111111111111111111111111
11111111111111111111111111111111111111111111011111111111111111111111111
11111111111111111111111111111111111111111111011111111111111111111111111
11111111111111111111111111111111111111111111011111111111111111111111111
11111111111111111111111111111111111111111111011111111111111111111111111
11111111111111111111111111111111111111111111011111111111111111111111111
11111111111111111111111111111111111111111111001111111111111111111111111
11111111111111111111111111111111111111111111101111111111111111111111111
11111111111111111111111111111111111111111111101111111111111111111111111
11111111111111111111111111111111111111111111101111111111111111111111111
11111111111111111111111111111111111111111111011111111111111111111111111
11111111111111111111111111111111111111111111011111111111111111111111111
11111111111111111111111111111111111111111111011111111111111111111111111
11111111111111111111111111111111111111111111011111111111111111111111111
11111111111111111111111111111111111111111111011111111111111111111111111
11111111111111111111111111111111111111111111011111111111111111111111111
11111111111111111111111111111111111111111111011111111111111111111111111
11111111111111111111111111111111111111111111011111111111111111111111111
11111111111111111111111111111111111111111111011111111111111111111111111
11111111111111111111111111111111111111111111001111111111111111111111111
11111111111111111111111111111111111111111111101111111111111111111111111
11111111111111111111111111111111111111111111101111111111111111111111111
11111111111111111111111111111111111111111111101111111111111111111111111
11111111111111111111111111111111111111111111011111111111111111111111111
11111111111111111111111111111111111111111111011111111111111111111111111
11111111111111111111111111111111111111111111011111111111111111111111111
11111111111111111111111111111111111111111111011111111111111111111111111
11111111111111111111111111111111111111111111011111111111111111111111111
11111111111111111111111111111111111111111111011111111111111111111111111
11111111111111111111111111111111111111111111011111111111111111111111111
11111111111111111111111111111111111111111111011111111111111111111111111
11111111111111111111111111111111111111111111011111111111111111111111111
11111111111111111111111111111111111111111111001111111111111111111111111
11111111111111111111111111111111111111111111101111111111111111111111111
11111111111111111111111111111111111111111111101111111111111111111111111
11111111111111111111111111111111111111111111101111111111111111111111111
11111111111111111111111111111111111111111111011111111111111111111111111
11111111111111111111111111111111111111111111011111111111111111111111111
11111111111111111111111111111111111111111111011111111111111111111111111
11111111111111111111111111111111111111111111011111111111111111111111111
11111111111111111111111111111111111111111111011111111111111111111111111
11111111111111111111111111111111111111111111011111111111111111111111111
11111111111111111111111111111111111111111111011111111111111111111111111
11111111111111111111111111111111111111111111011111111111111111111111111
11111111111111111111111111111111111111111111011111111111111111111111111
11111111111111111111111111111111111111111111001111111111111111111111111
11111111111111111111111111111111111111111111101111111111111111111111111
11111111111111111111111111111111111111111111101111111111111111111111111
11111111111111111111111111111111111111111111101111111111111111111111111
11111111111111111111111111111111111111111111011111111111111111111111111
11111111111111111111111111111111111111111111011111111111111111111111111
11111111111111111111111111111111111111111111011111111111111111111111111
11111111111111111111111111111111111111111111011111111111111111111111111
11111111111111111111111111111111111111111111011111111111111111111111111
11111111111111111111111111111111111111111111011111111111111111111111111
11111111111111111111111111111111111111111111011111111111111111111111111
11111111111111111111111111111111111111111111011111111111111111111111111
11111111111111111111111111111111111111111111011111111111111111111111111
11111111111111111111111111111111111111111111001111111111111111111111111
11111111111111111111111111111111111111111111101111111111111111111111111
11111111111111111111111111111111111111111111101111111111111111111111111
11111111111111111111111111111111111111111111101111111111111111111111111
11111111111111111111111111111111111111111111011111111111111111111111111
11111111111111111111111111111111111111111111011111111111111111111111111
11111111111111111111111111111111111111111111011111111111111111111111111
11111111111111111111111111111111111111111111011111111111111111111111111
11111111111111111111111111111111111111111111011111111111111111111111111
11111111111111111111111111111111111111111111011111111111111111111111111
11111111111111111111111111111111111111111111011111111111111111111111111
11111111111111111111111111111111111111111111011111111111111111111111111
11111111111111111111111111111111111111111111011111111111111111111111111
11111111111111111111111111111111111111111111001111111111111111111111111
11111111111111111111111111111111111111111111101111111111111111111111111
11111111111111111111111111111111111111111111101111111111111111111111111
11111111111111111111111111111111111111111111101111111111111111111111111
11111111111111111111111111111111111111111111011111111111111111111111111
11111111111111111111111111111111111111111111011111111111111111111111111
11111111111111111111111111111111111111111111011111111111111111111111111
11111111111111111111111111111111111111111111011111111111111111111111111
11111111111111111111111111111111111111111111011111111111111111111111111
11111111111111111111111111111111111111111111011111111111111111111111111
11111111111111111111111111111111111111111111011111111111111111111111111
11111111111111111111111111111111111111111111011111111111111111111111111
11111111111111111111111111111111111111111111011111111111111111111111111
11111111111111111111111111111111111111111111001111111111111111111111111
11111111111111111111111111111111111111111111101111111111111111111111111
11111111111111111111111111111111111111111111101111111111111111111111111
11111111111111111111111111111111111111111111101111111111111111111111111
11111111111111111111111111111111111111111111011111111111111111111111111
11111111111111111111111111111111111111111111011111111111111111111111111
11111111111111111111111111111111111111111111011111111111111111111111111
11111111111111111111111111111111111111111111011111111111111111111111111
11111111111111111111111111111111111111111111011111111111111111111111111
11111111111111111111111111111111111111111111011111111111111111111111111
11111111111111111111111111111111111111111111011111111111111111111111111
11111111111111111111111111111111111111111111011111111111111111111111111
11111111111111111111111111111111111111111111011111111111111111111111111
11111111111111111111111111111111111111111111001111111111111111111111111
11111111111111111111111111111111111111111111101111111111111111111111111
11111111111111111111111111111111111111111111101111111111111111111111111
11111111111111111111111111111111111111111111101111111111111111111111111
11111111111111111111111111111111111111111111011111111111111111111111111
11111111111111111111111111111111111111111111011111111111111111111111111
11111111111111111111111111111111111111111111011111111111111111111111111
11111111111111111111111111111111111111111111011111111111111111111111111
11111111111111111111111111111111111111111111011111111111111111111111111
11111111111111111111111111111111111111111111011111111111111111111111111
11111111111111111111111111111111111111111111011111111111111111111111111
11111111111111111111111111111111111111111111011111111111111111111111111
11111111111111111111111111111111111111111111011111111111111111111111111
11111111111111111111111111111111111111111111001111111111111111111111111
11111111111111111111111111111111111111111111101111111111111111111111111
11111111111111111111111111111111111111111111101111111111111111111111111
11111111111111111111111111111111111111111111101111111111111111111111111
11111111111111111111111111111111111111111111011111111111111111111111111
11111111111111111111111111111111111111111111011111111111111111111111111
11111111111111111111111111111111111111111111011111111111111111111111111
11111111111111111111111111111111111111111111011111111111111111111111111
11111111111111111111111111111111111111111111011111111111111111111111111
11111111111111111111111111111111111111111111011111111111111111111111111
11111111111111111111111111111111111111111111011111111111111111111111111
11111111111111111111111111111111111111111111011111111111111111111111111
11111111111111111111111111111111111111111111011111111111111111111111111
11111111111111111111111111111111111111111111001111111111111111111111111
11111111111111111111111111111111111111111111101111111111111111111111111
11111111111111111111111111111111111111111111101111111111111111111111111
11111111111111111111111111111111111111111111101111111111111111111111111
11111111111111111111111111111111111111111111011111111111111111111111111
11111111111111111111111111111111111111111111011111111111111111111111111
11111111111111111111111111111111111111111111011111111111111111111111111
11111111111111111111111111111111111111111111011111111111111111111111111
11111111111111111111111111111111111111111111011111111111111111111111111
11111111111111111111111111111111111111111111011111111111111111111111111
11111111111111111111111111111111111111111111011111111111111111111111111
11111111111111111111111111111111111111111111011111111111111111111111111
11111111111111111111111111111111111111111111011111111111111111111111111
11111111111111111111111111111111111111111111001111111111111111111111111
11111111111111111111111111111111111111111111101111111111111111111111111
11111111111111111111111111111111111111111111101111111111111111111111111
11111111111111111111111111111111111111111111101111111111111111111111111
11111111111111111111111111111111111111111111011111111111111111111111111
11111111111111111111111111111111111111111111011111111111111111111111111
11111111111111111111111111111111111111111111011111111111111111111111111
11111111111111111111111111111111111111111111011111111111111111111111111
11111111111111111111111111111111111111111111011111111111111111111111111
11111111111111111111111111111111111111111111011111111111111111111111111
11111111111111111111111111111111111111111111011111111111111111111111111
11111111111111111111111111111111111111111111011111111111111111111111111
11111111111111111111111111111111111111111111011111111111111111111111111
11111111111111111111111111111111111111111111001111111111111111111111111
11111111111111111111111111111111111111111111101111111111111111111111111
11111111111111111111111111111111111111111111101111111111111111111111111
11111111111111111111111111111111111111111111101111111111111111111111111
11111111111111111111111111111111111111111111011111111111111111111111111
11111111111111111111111111111111111111111111011111111111111111111111111
11111111111111111111111111111111111111111111011111111111111111111111111
11111111111111111111111111111111111111111111011111111111111111111111111
11111111111111111111111111111111111111111111011111111111111111111111111
11111111111111111111111111111111111111111111011111111111111111111111111
11111111111111111111111111111111111111111111011111111111111111111111111
11111111111111111111111111111111111111111111011111111111111111111111111
11111111111111111111111111111111111111111111011111111111111111111111111
11111111111111111111111111111111111111111111001111111111111111111111111
11111111111111111111111111111111111111111111101111111111111111111111111
11111111111111111111111111111111111111111111101111111111111111111111111
11111111111111111111111111111111111111111111101111111111111111111111111
11111111111111111111111111111111111111111111111111111111111111111111111