111111111111
1P01000010c1
10c101111001
100101000001
100100000001
100001010c01
100111011001
10000c0110E1
111111111111