1111111111111111111111111111111111111111
1P0000000000c00000c000000c00001111110001
1000100100001001001001111110001111110001
1000100111111001001001000000001000010001
1000100111111001001000111110001000010001
1000100100001001001000000E10001000000001
100000000000000000c000000010000000000001
1111111111111111111111111111111111111111
1111111111111111111111111111111111111111
1000000111000000111111111111111111111111
1000000111000000111111111111111111111111
1000000111000000111111111111111111111111
1111111111111111111111111111111111111111