111111111111
1Pc0c00010c1
100001111001
100101000001
100100000001
100001010c01
100111011001
10000c011E11
111111111111