111111111111
1P0100001001
100101111001
100101000001
100100000001
100001010001
100111011001
1000cE011001
111111111111