111111111111
1P0000001001
100001111001
100101000001
10010000c001
100001010001
100111011011
100000011E11
111111111111