1111111111111111111111111111111111111111111111111111111111
1000000001000000000111111111111111111111111111111111111111
1000000011110000000111111111111111111111111111111111111111
1001010000000000000000000000000000000000000000000000000001
1001000000000000C00111111111111111111111111111111111111111
100P000000000101000111111111111111111111111111111111111111
1000000000011101101111111111111111111111111111111111111111
10000000000000011E1111111111111111111111111111111111111111
111111101111110000C000001110111111111111111111111111111111
1111111011111111100000000001110111111111111111111111111111
1111111011111000000000011101111111111111111111111111111111
1111111011111111111111111111111111111111111111111111111111
1111111011111111111111111111111111111111111111111111111111
1111111011111111111111111111111111111111111111111111111111
1111111011111111111111111111111111111111111111111111111111
1111111000000000000000111111111111111111111111111111111111
1111111011111111111111111111111111111111111111111111111111
1111111011111111111111111111111111111111111111111111111111
1111111011111111111111111111111111111111111111111111111111
1111111011111111111111111111111111111111111111111111111111
1111111011111111111111111111111111100000000001110111111111
1111111011111111111111111111111111111111111111111111111111
1111111011111111111111111111111000000000011101111111111111
1111111011111111111111111111111111111111111111111111111111
1111111011111111111111111111111111111111111111111111111111
1111111011111111111111111111111111111111111111111111111111
1111111011111111111111111111111111111111111111111111111111
1111111011111111111111111111111111111111111111111111111111
1111111011111111111111111111111111111111111111111111111111
1111111011111111111111111111111111111111111111111111111111
1111111011111111111111111111111111111111111111111111111111
1111111011111111111111111111111111111111111111111111111111
1111111011111111111111111111111111111111111111111111111111
1111111011111111111111111111111111111111111101111111111111
1111111000000000000000000000000000000000000001111111111111
1111111111111111111111111111111111111111111101111111111111
1111111111111111111111111111111111111111111101111111111111
1111111111111111111111111111111111111111111101111111111111
1111111111111111111111111111111111111111111101111111111111
1111111111111111111111111111111111111111111101111111111111
1111111111111111111111111111111111111111111101111111111111
1111111111111111111111111111111111111111111101111111111111
1111111111111111111111111111111111111111111101111111111111
1111111111111111111111111111111111111111111101111111111111
1111111111111111111111111111111111111111111100111111111111
1111111111111111111111111111111111111111111110111111111111
1111111111111111111111111111111111111111111110111111111111
1111111111111111111111111111111111111111111110111111111111
1111111111111111111111111111111111111111111101111111111111
1111111111111111111111111111111111111111111111111111111111