1111111111
1001010001
1001011101
110101C011
100C000001
111010C011
1P0011E011
1111111111