1111111111
1P01010001
10C1011101
1101010011
10000000C1
1110100C11
10C0110E11
1111111111